................................
................................
................................
................................
................................
................................
................................
........smmmd......smmmd........
................................
................................
%.............................x.
.....smmmmmmmmmmmmmmmmmmmmd.....
................................
@@@..........................@@@
###..........................###
###..........................###
###..........................###
###..........................###
