................................
................................
................................
................................
................................
................................
................................
................................
................................
%.............................x.
................................
................................
###............................#
####..........................##
#####........................###
@@@@@$$$$$$$$$$$$$$$$$$$$$$$$@@@
@@@@@@@@@@@@@@@@@@@@@@@@@@@@@@@@
@@@@@@@@@@@@@@@@@@@@@@@@@@@@@@@@