................................
................................
................................
................................
................................
................................
................................
................................
................................
.%.......##############.......x.
................................
................................
####........................####
####........................####
####........................####
####........................####
####........................####
####........................####